19
15x25
#####
#===#######
#==$======##
##=######==##
 #=#====#=#=########
 #=#=##====$=======##
 #=#.===#@######=$==##
 #=#.#==###    ##=$==##
 #=#.====#      ##=$==##
 #=#.#===#  ##   ##=$==##
##=#.#==##  ###   ##=$==#
#==#.#===#  #*##   ##===#
#===.#=#=#  ##*##   #####
######===#  ######
     #####
