10
17x18
      ######
      #====#
      #=@==###
####  #======#
#==####..#.#$#####
#=$=$=##...======#
#=====.....#$$===#
######=##$##=#####
     #==$====#
     ####=####
       #==#
       #==#####
     ###=$====#
     #==$=$===#
     #=#$#=####
     #=====#
     #######
