15
11x9
   ####
   #@=#
  ##==#
  #=.$#
  #$.=#
###..$###
#==..$==#
#=$=$=#=#
#####=#=#
    #===#
    #####
