14
8x10
 #######
##=====# #
#==*.$.#
#==*.#.###
#=#$@$$==#
#===##=#=#
######===#
     #####
