17
12x23
    ###########
   ##=.=.=.=.=###
   #==$$=$=$=$==#
   #===########=# #####
 ####=##==$=====# #===#
 #====#==$=$=#==###=#=#
##==#=#===####=====$==#
#...==#####=$==####=###
#...=@=====$=====#====#
#...############=$==$=#
#####          #####==#
                   ####
