12
12x27
              #####
              #===#
    #####     #===#######
    #===##### #===.....=#
#####=#=##==# #=====#=#=#
#=$=$=$=$=$=# ##===##=$=#
#=#=##......####=###=$$=###
#======##=*=#====# #==$$==#
##########+$$===## #======#
         #.$=$#=#  ########
         #.##===#
         ########
