11
9x11
  ####
###==####
#===@===##
#=#.=.#.###
#=$$$=$$$=#
###.#.#.#=#
 ##=======#
  ####==###
     ####
