13
14x12
   #######
 ###=====##
 #===###==#
 #======#=#
###$#@==#=#
#===#####=#
#===#==*.=#
##$$#==*.##
 #=====*..#
 ####=#...##
    #=#$$$=#
    #===$==#
    #####==#
        ####
