18
15x8
    ####
#####==#
#======#
#$=$=$=#
#.*.*.*#
#*.*.*.#
#=$=$=$#
#......#
#.*.*.*#
#$=$=$=#
#=$=$=$#
#$=$=$=#
#======#
#@=#####
####
