Map 1
11x11

   ###
  ##=# ####
 ##==###==#
##=$======#
#===@$=#==#
###=$###==#
  #==#..==#
 ##=##.#=##
 #======##
 #=====##
 #######
