16
17x15
  ######
 ## #==###
## #===# ##
# #===$.# #
##==$=$.# #
#=#####.=##
#=====$.=@#
#=====$.=####
###=#=#*#=#=###
  ####=.$=====#
    #==.$=====#
    ##=.#####=#
    # #.$=$==##
    # #.$===# #
    ## #===# ##
     ###==# ##
       ######
