28
13x21
       ######
       #====###
   #####=$=$==#
####===#.#====##
#==$=#$#.##$#####
#=$$.=.#.$======##
#==$.#.#.#####==####
##==.......=@#=====#
 ####$=#.###=#$###$##
  ##=$==.==#==$=$=$=#
   #=$=###==========#
   #===# ############
   #####
