25
14x18
         #####
     #####==#####
     #==.#$===$=#
     #=#.=$$$=@=##
     #==.#$===$==#
     ###.#==$=$==#
       #.==##$=###
 #######*###.$=#
 #=$====....####
##=#$#$$....#
#==$=$===#..#
#=====$==#..#
#==##########
#####
