22
14x15
   ##### ####
   #@=.###==###
####==$$=$====#
#===#=.=.=##==#
#==$=#=.=.=##=#
##=.==$=$$==#=#
 #=#==###.==#=#
 #=####=#####=#
 #=======#====#
 #######=#=####
       #=.$=#
     ####===#
     ## #####
      ###
