24
14x14
        ######
        #===##
  #######=$==#
  #=$=$=$=#$=#
  #===#.=$===#
 ####.#.#=$###
 #===.....=#
 #==$=..##$#
###=##=..==#
#==$.#$=#=$#
#===$===#==#
##@==#==####
 ##==####
  ####
