2
9x9
 ## #####
## ##=.=#
# ##=$.=#
 ##=$===#
##=$@=###
#=$==##
#..=## ##
#===# ##
##### #
