20
8x9
     ####
     #==#
######$.#
#===$=$.#
#=$@$...#
#=$$$..##
#==$=..#
########
