26
11x18
           ####
 ###########==#
 #==$=$=$=$===##
 #==#=#=#=#=#$##
 ##.=.=.=.=.=.#
  #$#=#=#=#=#$####
###.=.=.=.=.=.===#
###$#=#=#=#=#=@==#
  #===$=$=$=$==###
  #==###########
  ####
