23
9x17
     #######
######=====######
#==.=..$#$..=.==#
#==$=$==.==$=$==#
###$####@####$###
#==$=$==.==$=$==#
#==.=..$#$..=.==#
######=====######
     #######
