27
16x24
      ########
 ######======##########
##=$=====###==========##
#=$=$=##=#==#########==#
#==$==#==============#=#
#=$=$=#=#==#########=#=#
#==$==#==#=#.=.=.=.==#=#
#=$=$=#=#====.=.=.=.##=#
#==$==#=#=#=.=.=.=.=#==#
##$=$##=#==####=#=#===##
 #===#@=#=======#==####
 ######==#####==#==#
      ##=====#==#==#
       #####==##==##
           ##====##
            ######
