21
6x15
##### ########
#===###=.=$==#
#===$=*..=#$=##
##=$#=..*=$==@#
 #==$=.=###===#
 ######## #####
