29
16x22
####
#==#              ####
#==######## #######==#
#=========###==##==$=#
##.######=...=====#.=#
 #.#======#=.#===#=$=#
 #$$$$#$$$=#.#===##.=#
 #.#=$===$=#..======##
 #.#==$==$===#=#===##
 #==#===$$=#===#####
 #.==##$==######
 #.===#==$.==#
##.=@=###.#$=#
#=====# #====#
#====## ######
######
