3
14x16
           #####
          ##===#
          #====#
    ####  #=$=##
    #==####$=$#
    #=====$=$=#
   ##=##=$=$=$#
   #==.#==$=$=#
   #==.#======#
#####=#########
#....=@==#
#....====#
##==######
 ####
