39
17x23
   ####           #####
   #==#######  ####===#
   #=@==$===####===$==#
   #==###.#====#==$$==#
 ###.##=$=#$=#====#==##
 #==..#=$=...#=###==##
 #=$=...$##.##=====##
 ##.###$=$..===$$=##
  #.==#.=.###=$=$=#
  #==$...## ##=#==#
 ##=######   #===##
##===##      #####
#=$$==#
#===$=#
###=$=#
  #==##
  ####
