35
17x26
 #####
 #===#
##=#=#####
#====##==#######
#=#=====$======####
#===####=$==$$=#==#
#####  #=$$$=$=#$=#
       #=$==$=$=$=######
     ###$===#$=$==$====#
     #=$=$$======###=@=##
     #==$=$$$$####...===#
     #==$=====$=#.=.#...#
     ###=$$$$===......==#
       #======##..#.....#
       ######=##.....####
            #===.....#   #
            ##########
