33
17x25
   #######
  ##=====##
  #==###==#
  #=##=$==####
  #=#=.#===$.####
  #=#=*=*###.$==#
  #=#=*#===###=#####
  #=#=@=*=*==#=#===#
  #=#==###=#*#==*==#
  #=##=#==*=*.#=#=#######
  #=#==#=====....$==$===#
  #=#=##=$#=$####$======#
###*===*=====#====#######
#===##########=####
#==============#
##==############
 ####
