31
9x23
       #########
       ###====##  ####
#####  #====*=##  #==#
#===####=****==####$.##
#=.$======*@*======$.=#
##.$####==****=####===#
 #==#  ##=*====#  #####
 ####  ##====###
       #########
