36
15x27
               #####
   ####        #===######
   #==#        #=$====$=#
   #==####     #==$##$==###
   #=====#########==#=$=$=#
   #======..........#===$=#
 ######=##....@###==#=$$==#
 #====#=#####.## #=##===$=#
 #============#  #$==$$=$=#
####=#==#####=#  #==$==#==#
#====#=#======#  ###===####
#======#==#===#    #####
#===#=====#####
#####=====#
    #######
