38
18x26
                      ####
  ####         ########==#
###@=##        #======#==#
#=====#        #=###=$=$=#
#=....##########===#==#..#
#=.=#==##=$===$=$#=#==#..#
###=#=====$==$$$=#=#=$=$=#
  #=...#=$==$$===#=#==#==#
  #==..#=$===$=$=#=#=##==#
  ##...#==$=$$=$=#$#=#####
   #===##=$==$=$===#=#
   ###=######==###=#=###
   #=.===## ####=.===.=#
  ##===.=#     #=#.#.#=#
  #==.===# # # #===#===#
  #=.=####     #########
  #==##
  ####
