34
17x26
            #####
            #=..########
            #=......#==#
            #..=##$$==$#
         #####.##===$==#
         #==....#=$==$$#
##### ## #==..=.#$==$==#
#===#    #=##.###==$$=$###
#===###  #=##=#==$==#====#
#=@===####=#==#=#=###$=#=#
#=============#==$====$==#
#===####======###=####$$##
#==##  ####=====#=======#
#==#      ##====######==#
####       ##=====# #=$=#
            ##====# #===#
             ###### #####
