32
16x24
                   #####
                   #===#
           #########=$=#
    ###### #===#===#===#
    #====# #=$=====$=#@#
  ###=##=####=###=##=###
  #===$==$=====#===#===#
  #==$==$=#=#$=#=$$=$$=#
 ######==$==#==#===#===#
##====##=###############
#==.#===$=#====#
#..====#==######
#...####==#
#....# ####
#....#
######
