37
17x29
  #####       #########
  #===#       #=======#
###=#$### #####=#=#=#=#####
#=$.=.==# #====.=.=.=.====#
#=#=#=#$###=#=#=#=#=#=#=#$#
#==.=.=.=.==$=$=$=$==.=.==#
###$#=#=#$###########$#=#$#
  #==.=.==##        #==.==#
  ###$#=#$####### # #$#=#$###
    #==.=.$=$=$=#   #==.=.==#
    #$#=#=#=#=#=#####$#=#=#=#
    #==.=.=.=.=.==$==.=.=.==#
    ###=#=#=#=#=#=#=#=#=#=#=#
      #=$=$.=.=.$=$=$=$=$=$=#
      #####=#=#=#############
          #==@==#
          #######
