30
14x26
     #####
     #===#
     #===#        ######
   ###==## #####  #====###
   #====#        ##=#$$==#
  ##$===##########=$==$==#
###==##=..........$==#$$@#
#====#=$$#=#######=$=====#
#===$==#...#     ###==####
#===#===$=### ##   ####
########====#
       #====#
       #====#
       ######
