43
18x30
   ####
  ##==#############
 ##====..........=#
##====#==####$###=##
#======#=#======#==##
#=====#==#=$$$==#=#=#####
#####==#=.=.#=###=.=.=.=##
    #===$.=.#==#=$$=$=$=@#
   #######=###=#===#######
   #=$===$===#=##=###
   #====$==$=#==#=## # ####
   #=$###=####==#=# # ##==####
   #==$=$$$==#=##=#  ##======#
   ##========#=##=####=$$$===#
    ##=#######=.....=====#####
    #==$=========######==#
    #===######==##    ####
    #####    ####
