47
14x22
#########
#=======#    ######
#===$===######====###
#=#$#$=$=$==#=$=====#
#=$===$@$==$=$=$=$$=#
#=$=$#=$=#=====$$$==#
#==$=$=#######===#####
##====###....#####=..#
 ###$$#=$$$$=#...*=..#
  #=========##===#..=#
  #==#==#$###....##*##
  #===##..$.=....====#
  ###=.*===.#....#===#
    ##################
