42
17x19
####
#==######
#=======####
#=$=$===#==#####
#####=###====$=#
 #==#===$==#===#
 #======##$######
 #=$###==#=...# #
 ##=#@#$=##.#.# #
 #====#===#...# #
 #=$=##$=$#...#####
 ###=##===#...====#
  #==#==$=$=$=#=#=#
  #=$###=######=#=#
  #=============#=#
  #############===#
              #####
