4
10x13
  ###########
 ##=====#==@#
###=$=$$#===#
# ##$====$$=#
#  #==$=#===#
######=######
#..=..$=#*##
#=..====###
#==..#####
#########
