41
14x24
   #####
   #===#
 ###===########
##==***====# # #
 #==*=*====## # #####
##==***===## # ##===##
 ###===#### # # #===#
   #===# # # ####$=$###
  ##===## # ##==$...$=##
   ##### # ##====.@.==#
        # # #===$...$=##
         ########$=$###
                #===#
                #####
