49 'Parallel Logic'
13x25
#########################
#==#==#==#==#==#==#==#==#
#=$#$=#=$#$=#=$#$=#=$#$=#
#==#==#==#==#==#==#==#==#
##=#=###=#=###=#=###=#=##
#==#==#==#==#==#==#==#==#
#=====#=====#=====#=====#
#=###=#=###=#=###=#=###=#
#==#==#==#==#==#==#==#==#
#==#=====#==$==#=====#==#
#==#=###=#=###=#=###=#==#
#==.=.=.==.=+=.==.=.=.==#
#########################
