45
18x23
  ####      ########
  #==##### ##===#==#
  #====$=###=$==$==#
  #==$=#=##====$===####
  ###==#====#=###$##==#
#####==###==####===$==#
#===#=$==$$##=..=##$==#
#==$$===#=$==========##
##==#=$##==####=#=####
###=#==##$=###..#..#
#===###..==#==.....###
#===#==*.###=#==#..==#
##$$#==*.##@=#==#====#
 #=====*.=####==###==#
 ######===#  #=======#
      #####  ##====###
              #==###
              ####
