44
18x24
 #############
##=======#===###
#==$=$$$$$=====#
###=$===$==###=#
  #=$=$=$### #=#
  ##===$=##  #=###
   ####===####===#
     ###=======#=###
   ####===####=====#
   #@=$===###==#.#=#####
   #=$=$=## #==....====#
   #=$$=##  ####.....==#
  ##=$==#     #..#.##==#
  #=$=$=##    #......==#
  #==$=$=#    #=.=..#=##
  ##==$==#    ##=##.#=#
   #====##     #======#
   ######      ########
