40
15x24
     #######
#### #=====#
#==###=$$$=#
#==....$==#####
#==..#=$==#==@#
###$##$####=#=######
 #.*....$==$==###==#####
 #=..#####==##===$=$===#
 #....*....=#==$$==#=$=#
 ##########=#$$=##=#===#
    #=$.###========$==##
    #=======$###$#=#==#
    #####===$====$=####
        ####====####
           ######
