48
17x23
   #### ####
  ##==# #==#  #######
###===###$=## #=====###
#==$======$=###=======#
#=$=$=###$===#==#=====#
###=###=#====#===#====#
#==$=#==##=###====#=###
#====$===#=#@========##
#=$#=#=###=###===#===#
#==$=#=#=$=$=#==#==#=#
##===#====$==#=#.====#
 ##==#=#===## #..==###
  ##=#=#==## #...=##
 ###=#=####=#....##
 #==========$.*.##
 ############..##
            ####
