5
15x15
  ###########
 ##====#====##
###=$=$#$=$=###
#=#$=$=#=$=$#=#
#=$==..#..==$=#
#==$...#...$==#
#=$=..=*=..=$=#
######=@=######
#=$=..===..=$=#
#==$...#...$==#
#=$==..#..==$=#
#=#$=$=#=$=$#=#
###=$=$#$=$=###
 ##====#====##
  ###########
