50 'Particle Theory'
15x27
  # # # # # # # # # # # #
 #=#=#=#=#=#=#=#=#=#=#=#=#
#===.$====.=$.==.=$===.$==#
 #=$#=#$#=#=#=#$#=#=#=#==#
#==.==.====$.==.==.$=.==.=#
 #=#$#=#=#=#=#$#$=$#=#$#=#
#=.=====.$=.$====.=$.==.==#
 #=$#=#=#=#=#@#=#=#=#=#$=#
#==.==.$=.====$.=$.=====.=#
 #=#$#=#$=$#$#=#=#=#=#$#=#
#=.==.=$.==.==.$====.==.==#
 #==#=#=#=#$#=#=#=#$#=#$=#
#==$.===$=.==.$=.====$.===#
 #=#=#=#=#=#=#=#=#=#=#=#=#
  # # # # # # # # # # # #
