6
12x15
  ###########
###.==.$.==.###
 ##=$==$==$=##
  ##=..$..=##
   ##$#$#$##
    #.$=$.#
    #==@==#
    ###=###
   ##=$=$=##
   #.==$==.#
   ###=.=###
     #####
