7
10x19
           ######
    ####  ##====#
  ###==#  #==##=###
###====####=#===$=#
#==$=@=...*..==$==#
#=$=$==##=###===###
###=###===# #####
 #======###
 #===####
 #####
