8
11x13
    #######
    #=====##
#####=###==##
#=======#==##
#@$***.=##$=#
#==#====##=.#
##==##==#=$=#
 ##==####.$.#
  ##========#
   ######==##
        ####
