9
9x9
#########
#.=.====#
#.$.=.==#
##=###@=#
 #==$==##
 #=$$=##
 #==$=#
 #==###
 ####
